{
  "metadata": {
    "name": "Sample Roguelike Map",
    "width": 40,
    "height": 30,
    "tile_size": 50
  },
  "legend": {
    ".": {
      "name": "meadow",
      "passable": true,
      "color": [50, 220, 50]
    },
    "#": {
      "name": "stone",
      "passable": false,
      "color": [128, 128, 128]
    },
    "~": {
      "name": "water",
      "passable": false,
      "color": [50, 50, 220]
    },
    "^": {
      "name": "mountain",
      "passable": false,
      "color": [100, 100, 100]
    }
  },
  "tiles": [
    "########################################",
    "#......................................#",
    "#......................................#",
    "#......................................#",
    "#.....##########.......................#",
    "#.....#........#.......................#",
    "#.....#........#.......................#",
    "#.....#........#.......................#",
    "#.....##########.......................#",
    "#......................................#",
    "#......................................#",
    "#..................~~~~................#",
    "#..................~~~~................#",
    "#..................~~~~................#",
    "#......................................#",
    "#......................................#",
    "#...........^^^^^^^^^^^................#",
    "#...........^^^^^^^^^^^................#",
    "#...........^^^^^^^^^^^................#",
    "#......................................#",
    "#......................................#",
    "#......................................#",
    "#..........##########..................#",
    "#..........#........#..................#",
    "#..........#........#..................#",
    "#..........#........#..................#",
    "#..........##########..................#",
    "#......................................#",
    "#......................................#",
    "########################################"
  ],
  "spawn_point": {
    "x": 5,
    "y": 5
  },
  "entities": {
    "monsters": [
      {"x": 35, "y": 15, "type": "banshee"},
      {"x": 20, "y": 8, "type": "leprechaun"},
      {"x": 15, "y": 25, "type": "pooka"}
    ],
    "chests": [
      {"x": 10, "y": 6, "looted": false},
      {"x": 30, "y": 20, "looted": false}
    ],
    "dungeons": [
      {"x": 20, "y": 15, "name": "Dark Cave"}
    ]
  }
}
